苑赞	yuanzan
苏琳	sulin
陆思芬	lusifen
于慧	yuhui
周杨	zhouyang
韩雪莲	hanxuelian
卢娜如	lunaru
张广思	zhanggs
刘三阳	liusanyang
吴爱伟	wuaiwei
苏亚磊	suyalei
冯施雨	fengshiyu
刘涛	liutao
周丽	zhoul
范旭宁	fanxuning
兰建忠	lanjianzhong
王彬安	wangban
杨玉梅	yangym
刘骏武	liujunwu
张举涛	zhangjutao
李广	liguang
陈茜	chenxi
涂成芳	tuchengfang
樊淑	fanshu
姚明月	yaomingyue
吴博欣	wubx
蒋涛	jiangtao
薛高	xuegao
周昆	zhoukun
占伟	zhanwei
郭同垒	guotonglei
郭同磊	guotonglei
李庆原	liqingyuan
李杨坤	liyangkun
